7; 6; 20; 23; 17; 16; 2; 3; 0; 1
51; 48; 49; 55; 52; 38; 37; 36; 39; 33; 34; 35; 32; 18; 19
56; 42; 41; 40; 43
60; 46; 47; 44; 45
31; 30; 29; 28; 14; 15; 12; 13
22; 21; 27; 26; 25; 24; 10; 11; 8; 9
61; 62; 63; 57; 58; 59; 53; 54
4; 5
50
